$$$ exec p1 : [calamber]
Plateau 11 19:
    0123456789012345678
000 ...................
001 ...................
002 ...................
003 .......X...........
004 ...................
005 ...................
006 ...................
007 ...................
008 ..............O....
009 ...................
010 ...................
Piece 3 5:
.....
..*..
..*..