$$$ exec p2 : [./calamber]
Plateau 100 99:
    012345678901234567890123456789012345678901234567890123456789012345678901234567890123456789012345678
000 ...................................................................................................
001 ...................................................................................................
002 ...................................................................................................
003 ...................................................................................................
004 ...................................................................................................
005 ...................................................................................................
006 ...................................................................................................
007 ...................................................................................................
008 ...................................................................................................
009 ...................................................................................................
010 ...................................................................................................
011 ...................................................................................................
012 ...................................................................................................
013 ...................................................................................................
014 ...................................................................................................
015 ...................................................................................................
016 ...................................................................................................
017 ...................................................................................................
018 ...................................................................................................
019 ...................................................................................................
020 ...................................................................................................
021 ...................................................................................................
022 ...................................................................................................
023 ...................................................................................................
024 ...................................................................................................
025 ...................................................................................................
026 ...................................................................................................
027 ...................................................................................................
028 ...................................................................................................
029 ..............................X....................................................................
030 ...................................................................................................
031 ...................................................................................................
032 ...................................................................................................
033 ...................................................................................................
034 ...................................................................................................
035 ...................................................................................................
036 ...................................................................................................
037 ...................................................................................................
038 .........................................OO........................................................
039 ......................................OOOOOO...O...................................................
040 ......................................OOOOOOO.OO...................................................
041 ......................................OOOO..OOOOOOO................................................
042 .........................................OOOO..O.OOO...............................................
043 .........................................OOO.OOOOOOO...............................................
044 .........................................OOO.OOO..OO...............................................
045 ...........................................O..OO...OO..............................................
046 ...........................................O.OOO...OOOOOO..........................................
047 ...........................................O.OOOO..OO..O........O..................................
048 ................................................O..OOOOO....OOO.O..................................
049 ................................................OOOO.OO.......OOO..................................
050 ................................................OOOO.OO......O..O..................................
051 .................................................OO..OO......O..O..................................
052 ......................................................O.........OO.................................
053 ......................................................O..........O.................................
054 ......................................................O........OOOOOOO.............................
055 ......................................................OOOOOOO...OOOOOOOO...........................
056 .........................................................OOOO....OO................................
057 .........................................................O.OO..OOOO................................
058 ...........................................................OOOOOOOO................................
059 ..............................................................O.OOOOO..............................
060 ..............................................................OOOO.................................
061 .............................................................OOOOOO................................
062 .............................................................OOOOOO................................
063 .............................................................OOO.O.................................
064 .............................................................OOOOOOO...............................
065 ...............................................................O.OOO...............................
066 ...............................................................OOOO.O..............................
067 .................................................................OOOO..............................
068 .................................................................OOOOOOOOO.........................
069 ..................................................................O...OO...........................
070 ...................................................................................................
071 ...................................................................................................
072 ...................................................................................................
073 ...................................................................................................
074 ...................................................................................................
075 ...................................................................................................
076 ...................................................................................................
077 ...................................................................................................
078 ...................................................................................................
079 ...................................................................................................
080 ...................................................................................................
081 ...................................................................................................
082 ...................................................................................................
083 ...................................................................................................
084 ...................................................................................................
085 ...................................................................................................
086 ...................................................................................................
087 ...................................................................................................
088 ...................................................................................................
089 ...................................................................................................
090 ...................................................................................................
091 ...................................................................................................
092 ...................................................................................................
093 ...................................................................................................
094 ...................................................................................................
095 ...................................................................................................
096 ...................................................................................................
097 ...................................................................................................
098 ...................................................................................................
099 ...................................................................................................
Piece 6 19:
...................
.............***...
.............*..***
................*..
..............*****
...................