$$$ exec p1 : [./calamber]
Plateau 100 99:
    012345678901234567890123456789012345678901234567890123456789012345678901234567890123456789012345678
000 ...................................................................................................
001 ...................................................................................................
002 ...................................................................................................
003 ...................................................................................................
004 ...................................................................................................
005 ...................................................................................................
006 ...................................................................................................
007 ...................................................................................................
008 ...................................................................................................
009 ...................................................................................................
010 ...................................................................................................
011 ...................................................................................................
012 ...................................................................................................
013 ...................................................................................................
014 ...................................................................................................
015 ...................................................................................................
016 ...................................................................................................
017 ...................................................................................................
018 ...................................................................................................
019 ...................................................................................................
020 ...................................................................................................
021 ...................................................................................................
022 ...................................................................................................
023 ...................................................................................................
024 .........................................................................................OO........
025 .........................................................................................OO........
026 ..........................................................................................OO....o..
027 ..........................................................................................OOOOO.ooo
028 ..........................................................................................OOOOO.oo.
029 ..............................X...........................................................O.OOO..oO
030 ..........................................................................................OOOOOOO..
031 ...........................................................................................OOOOOOO.
032 ...........................................................................................OOOOOOO.
033 ...........................................................................................OOOOO...
034 ...........................................................................................OOOOOOO.
035 ...........................................................................................O...O...
036 ...........................................................................................OO..OO..
037 ............................................................................................OO.OO.O
038 ............................................................................................OOOOO.O
039 ..............................................................................................OOO.O
040 .........................................................................................OO....OOOO
041 .........................................................................................OOOOOOOOOO
042 .......................................................................................OOOOOOOOOOO.
043 ......................................................................................O.OOOOOOOOOOO
044 ......................................................................................OOOOOOOOOOOOO
045 .........................................................................................OOOO.OOOOO
046 ........................................................................................OOOOOOOOOO.
047 .......................................................................................OOOOOOOOOOOO
048 .......................................................................................O.OOOOOOOOOO
049 .......................................................................................OO.OOOOOOO..
050 ....................................................................................OOOOOOOOOOOOOOO
051 .....................................................................................OO.OO.OO.OOOOO
052 ....................................................................................O.OOOOOO.O.OO.O
053 ...................................................................................O.OOO.OOOOOOOOOO
054 ...................................................................................OOOOOOO.OOOOO.O.
055 .................................................................................O.O.OOO.OOOOOOOOOO
056 ................................................................................OOOOOOOOOOOOOOOOOOO
057 ................................................................................OOO..O.OOOOOOOOOOO.
058 .................................................................................OOOOOOOOOOOOOOOOOO
059 .................................................................................OOOO.OOOOOOOOOOO.O
060 ................................................................................OOOO.OOOOOOOOOOOOOO
061 ...............................................................................OOOOO.OOO.OOOOOOOOOO
062 .................................................................................OOOOOO.OOOOOOOOOOO
063 .............................................................................OO.OOOOOOOOOOOOO.OOOOO
064 .............................................................................OOOOOOOOOOOOOOOOOOOOOO
065 ......................................................................O.OOOO..O.OOOOOOOOOOOOOOOOOOO
066 ....................................................................OOOOOOOOOOOOOOOOOOOOOOOOOOO.O.O
067 ...................................................................OOOOOOOOOOOO.OOOOOOOOOOOOOOOOOOO
068 .................................................................OOOOOOOOOOOOOOOOOOOOOOOOOOOOOOOOO.
069 ..................................................................OOOOO.OOOOOOOOOOOOOOOOOOOOOOOOOOO
070 ..................................................................O.OOOOOOOOOOOOOOOOOOOOOOOOOOOOOOO
071 ..................................................................OOOO.OOO.OOOOOOOOOOOOOOOOOOO.O.OO
072 ....................................................................OOOOOOOOOOOOOOOOOOOOOOOOOOOOOO.
073 ...................................................................OOOOOOOOOO.OOOOOOOOOOOOOOOOOOOOO
074 ...................................................................OOOOOOOOOOOOOOOOOOOOOOOOOOOOOOOO
075 ...................................................................O.OOOOOOOOOOOOOOOOOOOOOOOOOOOOOO
076 ...................................................................OOOO.OOOOOOOOOOOOOOOO.OOOOOOOOOO
077 ................................................................OOOO.OOOOOOOO.OOOO.OOOO.OOO.OOOOOOO
078 ...............................................................OO.OOOOOOOOOOOOOOO.OOOOOOO.OOOOOOOO.
079 ...............................................................OOO.OOOOOOOOOOO.OO.OOOOOOOOOOOO.OOO.
080 ........................................................OO.OOO.OOO.OOOOOOOOO.OOOOOOOO.OOOOOOOOOOOO.
081 .......................................................OOO..O..O.OOOOOO.OOOOOOO.OOOOO.O.OOOOOOOOOOO
082 ......................................................O.OO..OO.OOOOO..OOOOOOOOOOOOOOOOOOOOOOOOOOOOO
083 ......................................................OOOO.OOOOO..OOOOOOOOOOOOOOOOOOOOOO.OOO.O.OOOO
084 ..................................................OO..OOOOOOOOOOOOOOOOO.OOOOOO.OO.OOOOOOOOOOOOOOOOO
085 ..................................................OO....OOO.OOOOOOOOOOOOOOOOOOOOOO.O..OOOOOOO.OOOOO
086 .................................................OOOOOOOOO..OOOOOOOOO.OO.OOOOOOOOOOOOO.OOOOOO.OOOOO
087 ...........................................O..OO..OO.OOOOO.OO.OOOOOOO..OOO..OO.OOOO.OOOOOO.OOOOOOOO
088 ...............................O.O.........OOOOOOOOOOO.OOOOOOOOOOO.O.OOOOOOOOOOOOOOOOOOO.OOOOOOOOOO
089 ...........................O..OOOOOO.OOO..OO.OOO.OOOOO.OOOOOOOOOOOOOO.OOOOOOO.OOOO.OOOOO.OOOO.O.OOO
090 .........................OOOOOOO.OOOOOOOOOO.O.OOOOOOOO.O.OOOOO.OOOOOO..OOO.OOOOOOOOOOOOOOOOO.OOOOO.
091 .............................O.OOOOOOOO.OOOOOOOOOOO.OOOOOOOOOO.OOOO.OOOOOOOOOO...OOOOOOOO.OOOOOOOOO
092 ...............................OOO.OOO.OOOOO..OOOOOOOOO.OOOOOOOO.OO.OO.OOO....OOOOOOO..OOO.OO.OOOOO
093 ...............................OOO.OOOOOOOOOOOOOOOOOOOOOOOOO.OOOOOOOOO..OOOOO.OO..OOOOOOOOOOO.OOOOO
094 ...............................OOO..OOOOOO.O.O..O.OOO.OOO.OO.OOOOOOO.OOOO.OO..OOOOOOOOOOOOOO.OOOOOO
095 .............................OOOOO.OOOOOOOOOOOOOOO.OO.OOOOOO.OOOOO.OOOOO.OOO.OOOOOOOOOOOOO..OO..OO.
096 .............................OOOOOOOOOOOOOOOOOOOOOO.O.OOOOOOOO.OOOOOOOOOOOOOOO.OOOO.OOOOO.OOOOOOOO.
097 .............................OOOOOOOOOOOOO..OOO.OOOOO.OOOOOOOOO.OOOOOOOOOOOOOOO.OOOOOO.OOOOOOOOOOO.
098 ............................OO...OOOOOOOOO.OO.OO.OOOOOOOOOOO.OO.O.OOOOOOOOO...OOOOOOOOOOOOOOOOOOOOO
099 ............................O.....OOO..OOOOO...OO.OO......O...OOOOOO.OOOOOO...OOO.OOOOO..OO.....OOO
Piece 53 19:
...................
...................
...................
...................
...................
...................
...................
...................
...................
...................
...................
...................
...................
...................
...................
...................
...................
...................
...................
...................
...................
...................
...................
...................
...................
...................
...................
...................
...................
...................
...................
...................
...................
...................
.............***...
.............*..***
................*..
..............*****
...................
...................
...................
...................
...................
...................
...................
...................
...................
...................
...................
...................
...................
...................
...................