$$$ exec p1 : [./calamber]
Plateau 24 40:
    0123456789012345678901234567890123456789
000 OOOOOO...OOOOO...OOOO...................
001 OOOOOOOOOOOOOO...OOOoo..................
002 OOOOOOOO.OOOO...OOOOooo.................
003 OOOOOOOOOOOOOOOOOOOoo.o.................
004 OOOO.OOO.OOOOOOOOOOO....................
005 OOOOOOOO.OOOOOOOOOOO....................
006 OOOOOOO...OOOOOO.OOO....................
007 O.OOOO..OOOOOOOOOOOO....................
008 O.OOO...OOOOOOO.OOOO....................
009 ..O.O.OOOOOOOOO.OOO.....................
010 OOOOOOOOOOOOOOO.........................
011 OOO.OOOOOOOOOO..........................
012 OOOOOOOOOOOOOO..........................
013 OOO.OOOOOOOO............................
014 ...OO.O.O.OO............................
015 ....OOOOO...............................
016 ..OOOO.OO...............................
017 ..OOOOOOOO..............................
018 OOOOOOOOOO..............................
019 OO.O.OOOO.......................X.......
020 .OOO....................................
021 ........................................
022 ........................................
023 ........................................
Piece 4 6:
..***.
..***.
......
......