$$$ exec p1 : [calamber]
Plateau 11 19:
    0123456789012345678
000 ...................
001 .O.................
002 ...................
003 ...................
004 ...................
005 ...................
006 ...................
007 ...................
008 ...................
009 ...................
010 ...................
Piece 4 6:
......
......
..***.
...*..